na h-Eileanan Fàrach	(Scots Gaelic)
na h-Eileanan Fàro	(Scots Gaelic)
Fääri saared	(Estonian)
Fääri saarõq	(Võro)
Faero	(Breton)
Faeröer	(Dutch)
Faerské ostrovy	(Czech Slovak)
法羅群島	(Mandarin Chinese)
法罗群岛	(Mandarin Chinese)
Farer adaları	(Azeri)
Фарэрскія астравы	(Belarusian)
Фарерські острови	(Ukrainian)
Farēru salas	(Latvian)
Farerų Salos	(Lithuanian)
ෆාරෝ දිවයින්	(Sinhala)
Färöarna	(Swedish)
Faroe Adaları	(Turkish)
Färöer	(Alemannic Austro-Bavarian German)
Faroëreilande	(Afrikaans)
Ֆարոյան Կղզիներ	(Armenian)
Färsaaret	(Finnish)
Farska ostrva	(Bosnian)
Фарска острва	(Serbian)
Фарски острови	(Macedonian)
Фарьорски острови	(Bulgarian)
Færeyjar	(Icelandic)
Færøerne	(Danish)
Færøyene	(Norwegian)
Feröer-szigetek	(Hungarian)
Ferooj	(Esperanto)
フェロー諸島	(Japanese)
Ferski otoki	(Slovene)
Føroyar	(Faroese)
il-Gżejjer Faroe	(Maltese)
Iles Fèroè	(Franco-Provençal)
Îles Féroé	(French)
Ilhas Faroé	(Portuguese)
Ilhas Feroé	(Portuguese variant)
Insulele Feroe	(Romanian)
Islas Feroe	(Spanish)
Islles Feroe	(Asturian)
Isole Fær Øer	(Italian)
איי פארו	(Hebrew)
Kapuluang Faroe	(Filipino/Tagalog)
Kepulauan Faroe	(Indonesian)
Mî-iûⁿ Kûn-tó	(Min Nan)
หมู่เกาะแฟโร	(Thai)
Νήσοι Φερόες	(Greek)
Paruu Qikiqtat	(Inuktitut)
페로 제도	(Korean)
Pharuy	(Quechua)
Pulo-pulo Faroe	(Acehnese)
Wyspy Owcze	(Polish)
Ynysoedd Ffaro	(Welsh)
பரோயே தீவுகள்	(Tamil)
جزایر فارو	(Persian)
جزر فارو	(Arabic)
