芬蘭	(Mandarin Chinese)
芬兰	(Mandarin Chinese)
Fennia	(Latin variant)
Finnia	(Latin varian)
y Ffindir	(Welsh)
an Fhionlainn	(Irish)
Finland	(Afrikaans Bambara Danish Dutch Malay Swedish)
ፊንላንድ	(Amharic)
פינלנד	(Hebrew)
פֿינלאַנד	(Yiddish)
ෆින්ලන්තය	(Sinhala)
ฟินแลนด์	(Thai)
Finlanda	(Albanian Aromanian Romanian Romansh)
Finlandë	(Albanian)
Finlande	(Franco-Provençal French)
Ֆինլանդիա	(Armenian)
Finlandia	(Acehnese Aragonese Asturian Basque Indonesian Italian Latin Polish Spanish)
Finlàndia	(Catalan)
Φινλανδία	(Greek)
Finlândia	(Portuguese)
Фінляндія	(Ukrainian)
Finlandiya	(Azeri Turkish)
Финландия	(Bulgarian)
il-Finlandja	(Maltese)
ෆින්ලන්තය	(Sinhala)
Финляндия	(Russian)
Finnland	(Alemannic Faroese German Icelandic Low Saxon)
Finnlando	(Esperanto)
Finnország	(Hungarian)
フィンランド	(Japanese)
Finska	(Croatian Lower Sorbian Slovene)
Финска	(Macedonian Serbian)
Finsko	(Czech)
Fínsko	(Slovak)
Hĩlandia	(Guaraní)
Phần Lan	(Vietnamese)
Phinsuyu	(Quechua)
핀란드	(Korean)
ფინეთი	(Georgian)
Pinlandiya	(Filipino/Tagalog)
Pinranti	(Inuktitut)
Somija	(Latvian)
Soome	(Estonian)
Soomõ	(Võro)
Suòmaidh	(Scots Gaelic)
Suomi	(Finnish)
Suomija	(Lithuanian)
Suopma	(Sami)
பின்லாந்து	(Tamil)
فنلاند	(Persian)
Ufini	(Swahili)
فنلندا	(Arabic)
