Akullirmiutavik	(Inuktitut)
Kalaallirmiutavik	(Inuktitut)
বুজভূমি	(Bengali)
গ্রিনল্যান্ড	(Bengali)
Chheⁿ-tē	(Min Nan)
格陵蘭	(Mandarin Chinese)
格陵兰	(Mandarin Chinese)
གེ་རེན་ལ	(Tibetan)
그린란드	(Korean)
an Ghraonlainn	(Irish)
Grænland	(Icelandic)
a' Ghraonlainn	(Scots Gaelic)
Գրելանդիա	(Armenian)
Grenland	(Albanian Bosnian Croatian)
Гренланд	(Macedonian Serbian)
Grenlande	(Latvian)
גרינלנד	(Hebrew)
Grenlandia	(Polish)
Grenlandija	(Lithuanian Slovene)
Гpeнлaндия	(Bulgarian Russian)
Гренландія	(Ukrainian)
Γροιλανδία	(Greek)
ግሪንላንድ	(Amharic)
ග්රීන්ලන්තය	(Sinhala)
Groelândia	(Portuguese variant)
Groenland	(Afrikaans Dutch French)
Groenlanda	(Romanian)
Groenlandia	(Asturian Italian Latin Spanish)
Groenlândia	(Portuguese variant)
Gronelândia	(Portuguese)
Grönland	(Austro-Bavarian German Hungarian Swedish Turkish)
Grønland	(Danish Faroese)
Grönlanda	(Romansh)
Grônlande	(Franco-Provençal)
Gronlandia	(Aragonese)
Gronlando	(Esperanto)
Grönlandska	(Lower Sorbian)
Grönlanti	(Finnish)
Grónsko	(Czech Slovak)
Gröönimaa	(Estonian Võro)
Gröönland	(Low Saxon)
グリーンランド	(Japanese)
Грэнландыя	(Belarusian)
Kalaallit Nunaat	(Kalaallisut)
Kalalit Nunat	(Quechua)
กรีนแลนด์	(Thai)
y Lasynys	(Welsh)
Lupanlunti	(Filipino/Tagalog)
Qrenlandiya	(Azeri)
Tanah Hijau	(Indonesian)
ிரீன்லாந்து	(Tamil)
گروئنلند	(Persian)
جرينلاند	(Arabic)
